# Avida instruction execution data
# Wed Feb 29 10:20:18 2012
#  1: Update
#  2: nop-A
#  3: nop-B
#  4: nop-C
#  5: if-n-equ
#  6: if-less
#  7: pop
#  8: push
#  9: swap-stk
# 10: swap
# 11: shift-r
# 12: shift-l
# 13: inc
# 14: dec
# 15: add
# 16: sub
# 17: nand
# 18: IO
# 19: h-alloc
# 20: h-divide
# 21: h-copy
# 22: h-search
# 23: mov-head
# 24: jmp-head
# 25: get-head
# 26: if-label
# 27: set-flow
# 28: rotate-left-one
# 29: rotate-right-one
# 30: set-opinion
# 31: get-opinion
# 32: send-msg
# 33: retrieve-msg
# 34: bcast1
# 35: collect-cell-data
# 36: get-cell-xy
# 37: nop-X

0 0 0 0 0 0 0 0 0 0 0 0 0 0 0 0 0 0 0 0 0 0 0 0 0 0 0 0 0 0 0 0 0 0 0 0 0 
1 0 0 0 0 0 0 0 0 0 0 0 0 0 0 0 0 0 0 0 0 0 0 0 0 0 0 0 0 0 0 0 0 0 0 0 0 
2 0 0 0 0 0 0 0 0 0 0 0 0 0 0 0 0 0 0 0 0 0 0 0 0 0 0 0 0 0 0 0 0 0 0 0 0 
3 0 0 0 0 0 0 0 0 0 0 0 0 0 0 0 0 0 0 0 0 0 0 0 0 0 0 0 0 0 0 0 0 0 0 0 0 
4 0 0 0 0 0 0 0 0 0 0 0 0 0 0 0 0 0 0 0 0 0 0 0 0 0 0 0 0 0 0 0 0 0 0 0 0 
5 0 0 0 0 0 0 0 0 0 0 0 0 0 0 0 0 0 0 0 0 0 0 0 0 0 0 0 0 0 0 0 0 0 0 0 0 
6 0 0 0 0 0 0 0 0 0 0 0 0 0 0 0 0 0 0 0 0 0 0 0 0 0 0 0 0 0 0 0 0 0 0 0 0 
7 0 0 0 0 0 0 0 0 0 0 0 0 0 0 0 0 0 0 0 0 0 0 0 0 0 0 0 0 0 0 0 0 0 0 0 0 
8 0 0 0 0 0 0 0 0 0 0 0 0 0 0 0 0 0 0 0 0 0 0 0 0 0 0 0 0 0 0 0 0 0 0 0 0 
9 0 0 0 0 0 0 0 0 0 0 0 0 0 0 0 0 0 0 0 0 0 0 0 0 0 0 0 0 0 0 0 0 0 0 0 0 
10 0 0 0 0 0 0 0 0 0 0 0 0 0 0 0 0 0 0 0 0 0 0 0 0 0 0 0 0 0 0 0 0 0 0 0 0 
11 0 0 0 0 0 0 0 0 0 0 0 0 0 0 0 0 0 0 0 0 0 0 0 0 0 0 0 0 0 0 0 0 0 0 0 0 
12 0 0 0 0 0 0 0 0 0 0 0 0 0 0 0 0 0 0 0 0 0 0 0 0 0 0 0 0 0 0 0 0 0 0 0 0 
13 0 0 0 0 0 0 0 0 0 0 0 0 0 0 0 0 0 0 0 0 0 0 0 0 0 0 0 0 0 0 0 0 0 0 0 0 
14 0 0 0 0 0 0 0 0 0 0 0 0 0 0 0 0 0 0 0 0 0 0 0 0 0 0 0 0 0 0 0 0 0 0 0 0 
15 0 0 0 0 0 0 0 0 0 0 0 0 0 0 0 0 0 0 0 0 0 0 0 0 0 0 0 0 0 0 0 0 0 0 0 0 
16 0 0 0 0 0 0 0 0 0 0 0 0 0 0 0 0 0 0 0 0 0 0 0 0 0 0 0 0 0 0 0 0 0 0 0 0 
17 0 0 0 0 0 0 0 0 0 0 0 0 0 0 0 0 0 0 0 0 0 0 0 0 0 0 0 0 0 0 0 0 0 0 0 0 
18 0 0 0 0 0 0 0 0 0 0 0 0 0 0 0 0 0 0 0 0 0 0 0 0 0 0 0 0 0 0 0 0 0 0 0 0 
19 0 0 0 0 0 0 0 0 0 0 0 0 0 0 0 0 0 0 0 0 0 0 0 0 0 0 0 0 0 0 0 0 0 0 0 0 
20 0 0 0 0 0 0 0 0 0 0 0 0 0 0 0 0 0 0 0 0 0 0 0 0 0 0 0 0 0 0 0 0 0 0 0 0 
21 0 0 0 0 0 0 0 0 0 0 0 0 0 0 0 0 0 0 0 0 0 0 0 0 0 0 0 0 0 0 0 0 0 0 0 0 
22 0 0 0 0 0 0 0 0 0 0 0 0 0 0 0 0 0 0 0 0 0 0 0 0 0 0 0 0 0 0 0 0 0 0 0 0 
23 0 0 0 0 0 0 0 0 0 0 0 0 0 0 0 0 0 0 0 0 0 0 0 0 0 0 0 0 0 0 0 0 0 0 0 0 
24 0 0 0 0 0 0 0 0 0 0 0 0 0 0 0 0 0 0 0 0 0 0 0 0 0 0 0 0 0 0 0 0 0 0 0 0 
25 0 0 0 0 0 0 0 0 0 0 0 0 0 0 0 0 0 0 0 0 0 0 0 0 0 0 0 0 0 0 0 0 0 0 0 0 
26 0 0 0 0 0 0 0 0 0 0 0 0 0 0 0 0 0 0 0 0 0 0 0 0 0 0 0 0 0 0 0 0 0 0 0 0 
27 0 0 0 0 0 0 0 0 0 0 0 0 0 0 0 0 0 0 0 0 0 0 0 0 0 0 0 0 0 0 0 0 0 0 0 0 
28 0 0 0 0 0 0 0 0 0 0 0 0 0 0 0 0 0 0 0 0 0 0 0 0 0 0 0 0 0 0 0 0 0 0 0 0 
29 0 0 0 0 0 0 0 0 0 0 0 0 0 0 0 0 0 0 0 0 0 0 0 0 0 0 0 0 0 0 0 0 0 0 0 0 
30 3 3 3 6 306 9 615 3 9 3 6 6 303 0 306 9 12 3 3 312 9 303 0 0 312 12 9 9 6 24 6 6 12 0 9 9 
31 10 10 10 20 1027 30 2064 10 30 10 20 9 1017 0 1027 37 40 10 10 1040 30 1017 0 0 1047 40 30 30 20 80 20 20 40 0 30 30 
32 16 16 16 32 1641 48 3298 16 48 16 32 20 1625 0 1641 57 64 16 16 1664 48 1625 0 0 1673 64 48 48 32 128 32 32 64 0 48 48 
33 21 21 21 42 2157 63 4335 21 63 21 42 18 2136 0 2157 78 84 21 21 2184 63 2136 0 0 2199 84 63 63 42 168 42 42 84 0 63 63 
34 25 25 25 50 2567 75 5159 25 75 25 50 25 2542 0 2567 92 100 25 25 2600 75 2542 0 0 2617 100 75 75 50 200 50 50 100 0 75 75 
35 25 25 25 50 2567 75 5159 25 75 25 50 25 2542 0 2567 92 100 25 25 2600 75 2542 0 0 2617 100 75 75 50 200 50 50 100 0 75 75 
36 25 25 25 50 2567 75 5159 25 75 25 50 25 2542 0 2567 92 100 25 25 2600 75 2542 0 0 2617 100 75 75 50 200 50 50 100 0 75 75 
37 25 25 25 50 2567 75 5159 25 75 25 50 25 2542 0 2567 92 100 25 25 2600 75 2542 0 0 2617 100 75 75 50 200 50 50 100 0 75 75 
38 25 25 25 50 2567 75 5159 25 75 25 50 25 2542 0 2567 92 100 25 25 2600 75 2542 0 0 2617 100 75 75 50 200 50 50 100 0 75 75 
39 25 25 25 50 2567 75 5159 25 75 25 50 25 2542 0 2567 92 100 25 25 2600 75 2542 0 0 2617 100 75 75 50 200 50 50 100 0 75 75 
40 25 25 25 50 2567 75 5159 25 75 25 50 25 2542 0 2567 92 100 25 25 2600 75 2542 0 0 2617 100 75 75 50 200 50 50 100 0 75 75 
41 25 25 25 50 2567 75 5159 25 75 25 50 25 2542 0 2567 92 100 25 25 2600 75 2542 0 0 2617 100 75 75 50 200 50 50 100 0 75 75 
42 25 25 25 50 2567 75 5159 25 75 25 50 25 2542 0 2567 92 100 25 25 2600 75 2542 0 0 2617 100 75 75 50 200 50 50 100 0 75 75 
43 25 25 25 50 2567 75 5159 25 75 25 50 25 2542 0 2567 92 100 25 25 2600 75 2542 0 0 2617 100 75 75 50 200 50 50 100 0 75 75 
44 25 25 25 50 2567 75 5159 25 75 25 50 25 2542 0 2567 92 100 25 25 2600 75 2542 0 0 2617 100 75 75 50 200 50 50 100 0 75 75 
45 25 25 25 50 2567 75 5159 25 75 25 50 25 2542 0 2567 92 100 25 25 2600 75 2542 0 0 2617 100 75 75 50 200 50 50 100 0 75 75 
46 25 25 25 50 2567 75 5159 25 75 25 50 25 2542 0 2567 92 100 25 25 2600 75 2542 0 0 2617 100 75 75 50 200 50 50 100 0 75 75 
47 25 25 25 50 2567 75 5159 25 75 25 50 25 2542 0 2567 92 100 25 25 2600 75 2542 0 0 2617 100 75 75 50 200 50 50 100 0 75 75 
48 25 25 25 50 2567 75 5159 25 75 25 50 25 2542 0 2567 92 100 25 25 2600 75 2542 0 0 2617 100 75 75 50 200 50 50 100 0 75 75 
49 25 25 25 50 2567 75 5159 25 75 25 50 25 2542 0 2567 92 100 25 25 2600 75 2542 0 0 2617 100 75 75 50 200 50 50 100 0 75 75 
50 25 25 25 50 2567 75 5159 25 75 25 50 25 2542 0 2567 92 100 25 25 2600 75 2542 0 0 2617 100 75 75 50 200 50 50 100 0 75 75 
51 25 25 25 50 2567 75 5159 25 75 25 50 25 2542 0 2567 92 100 25 25 2600 75 2542 0 0 2617 100 75 75 50 200 50 50 100 0 75 75 
52 25 25 25 50 2567 75 5159 25 75 25 50 25 2542 0 2567 92 100 25 25 2600 75 2542 0 0 2617 100 75 75 50 200 50 50 100 0 75 75 
53 25 25 25 50 2567 75 5159 25 75 25 50 25 2542 0 2567 92 100 25 25 2600 75 2542 0 0 2617 100 75 75 50 200 50 50 100 0 75 75 
54 25 25 25 50 2567 75 5159 25 75 25 50 25 2542 0 2567 92 100 25 25 2600 75 2542 0 0 2617 100 75 75 50 200 50 50 100 0 75 75 
55 25 25 25 50 2567 75 5159 25 75 25 50 25 2542 0 2567 92 100 25 25 2600 75 2542 0 0 2617 100 75 75 50 200 50 50 100 0 75 75 
56 25 25 25 50 2567 75 5159 25 75 25 50 25 2542 0 2567 92 100 25 25 2600 75 2542 0 0 2617 100 75 75 50 200 50 50 100 0 75 75 
57 25 25 25 50 2567 75 5159 25 75 25 50 25 2542 0 2567 92 100 25 25 2600 75 2542 0 0 2617 100 75 75 50 200 50 50 100 0 75 75 
58 25 25 25 50 2567 75 5159 25 75 25 50 25 2542 0 2567 92 100 25 25 2600 75 2542 0 0 2617 100 75 75 50 200 50 50 100 0 75 75 
59 25 25 25 50 2567 75 5159 25 75 25 50 25 2542 0 2567 92 100 25 25 2600 75 2542 0 0 2617 100 75 75 50 200 50 50 100 0 75 75 
60 25 25 23 50 2567 75 5159 25 75 27 50 26 2542 0 2567 92 100 25 25 2600 75 2542 0 0 2617 100 75 75 50 200 50 50 100 0 75 75 
61 24 25 21 50 2568 75 5159 25 75 29 50 30 2542 0 2567 92 100 25 25 2600 75 2542 0 0 2617 100 74 75 50 200 50 50 100 0 75 75 
62 24 25 17 50 2569 73 5157 25 73 31 50 32 2541 0 2566 91 102 25 25 2600 75 2541 0 2 2616 100 74 75 50 202 50 50 98 0 75 75 
63 24 25 17 50 2570 73 5157 25 73 31 50 28 2542 0 2567 92 102 25 25 2600 76 2542 0 2 2617 100 74 75 50 202 51 50 98 0 75 75 
64 24 25 17 50 2570 73 5157 25 73 31 50 28 2542 0 2567 92 102 25 25 2600 76 2542 0 2 2617 100 74 75 50 202 51 50 98 0 75 75 
65 24 25 17 50 2570 73 5157 25 73 31 50 28 2542 0 2567 92 102 25 25 2600 76 2542 0 2 2617 100 74 75 50 202 51 50 98 0 75 75 
66 24 25 17 50 2570 73 5157 25 73 31 50 28 2542 0 2567 92 102 25 25 2600 76 2542 0 2 2617 100 74 75 50 202 51 50 98 0 75 75 
67 24 25 17 50 2570 73 5157 25 73 31 50 28 2542 0 2567 92 102 25 25 2600 76 2542 0 2 2617 100 74 75 50 202 51 50 98 0 75 75 
68 24 25 17 50 2570 73 5157 25 73 31 50 28 2542 0 2567 92 102 25 25 2600 76 2542 0 2 2617 100 74 75 50 202 51 50 98 0 75 75 
69 24 25 17 50 2570 73 5157 25 73 31 50 28 2542 0 2567 92 102 25 25 2600 76 2542 0 2 2617 100 74 75 50 202 51 50 98 0 75 75 
70 24 25 17 50 2570 73 5157 25 73 31 50 28 2542 0 2567 92 102 25 25 2600 76 2542 0 2 2617 100 74 75 50 202 51 50 98 0 75 75 
71 24 25 17 50 2570 73 5157 25 73 31 50 28 2542 0 2567 92 102 25 25 2600 76 2542 0 2 2617 100 74 75 50 202 51 50 98 0 75 75 
72 24 25 17 50 2570 73 5157 25 73 31 50 28 2542 0 2567 92 102 25 25 2600 76 2542 0 2 2617 100 74 75 50 202 51 50 98 0 75 75 
73 24 25 17 50 2570 73 5157 25 73 31 50 28 2542 0 2567 92 102 25 25 2600 76 2542 0 2 2617 100 74 75 50 202 51 50 98 0 75 75 
74 24 25 17 50 2570 73 5157 25 73 31 50 28 2542 0 2567 92 102 25 25 2600 76 2542 0 2 2617 100 74 75 50 202 51 50 98 0 75 75 
75 24 25 15 50 2571 73 5159 25 73 31 50 27 2543 0 2568 93 102 25 25 2600 76 2543 0 2 2618 100 74 75 50 202 51 50 98 0 75 75 
76 24 25 15 50 2571 73 5159 25 73 31 50 27 2543 0 2568 93 102 25 25 2600 76 2543 0 2 2618 100 74 75 50 202 51 50 98 0 75 75 
77 24 25 14 50 2572 73 5161 25 73 31 50 26 2544 0 2569 94 102 25 25 2600 76 2544 0 2 2619 100 74 75 50 202 51 50 98 0 75 75 
78 24 25 14 50 2572 73 5161 25 73 31 50 26 2544 0 2569 94 102 25 25 2600 76 2544 0 2 2619 100 74 75 50 202 51 50 98 0 75 75 
79 68 26 13 52 2572 75 5164 26 75 31 52 25 2544 0 2571 97 105 25 25 2600 78 2545 1 2 2622 103 77 78 51 209 53 52 100 0 77 78 
80 68 26 13 52 2572 75 5164 26 75 31 52 25 2544 0 2571 97 105 25 25 2600 78 2545 1 2 2622 103 77 78 51 209 53 52 100 0 77 78 
81 68 26 13 52 2572 75 5164 26 75 31 52 25 2544 0 2571 97 105 25 25 2600 78 2545 1 2 2622 103 77 78 51 209 53 52 100 0 77 78 
82 68 26 13 52 2572 75 5164 26 75 31 52 25 2544 0 2571 97 105 25 25 2600 78 2545 1 2 2622 103 77 78 51 209 53 52 100 0 77 78 
83 68 26 13 52 2572 75 5164 26 75 31 52 25 2544 0 2571 97 105 25 25 2600 78 2545 1 2 2622 103 77 78 51 209 53 52 100 0 77 78 
84 68 26 13 52 2572 75 5164 26 75 31 52 25 2544 0 2571 97 105 25 25 2600 78 2545 1 2 2622 103 77 78 51 209 53 52 100 0 77 78 
85 68 26 13 52 2572 75 5164 26 75 31 52 25 2544 0 2571 97 105 25 25 2600 78 2545 1 2 2622 103 77 78 51 209 53 52 100 0 77 78 
86 68 26 13 52 2572 75 5164 26 75 31 52 25 2544 0 2571 97 105 25 25 2600 78 2545 1 2 2622 103 77 78 51 209 53 52 100 0 77 78 
87 24 25 12 50 2574 73 5165 25 73 29 52 24 2546 0 2569 96 102 25 25 2600 76 2546 2 2 2619 100 74 75 50 202 51 48 98 0 75 77 
88 24 25 11 50 2574 74 5167 25 74 31 52 24 2547 0 2570 97 101 25 25 2600 76 2547 2 1 2620 100 74 75 50 202 51 48 98 0 75 77 
89 24 25 12 50 2574 74 5167 25 74 31 51 22 2547 0 2571 97 101 25 25 2600 76 2547 1 1 2621 100 74 75 50 201 51 49 99 0 75 76 
90 24 25 11 50 2574 74 5167 25 74 33 51 22 2547 0 2571 97 101 25 25 2600 76 2547 1 1 2621 100 74 75 50 201 51 49 99 0 75 76 
91 25 25 11 50 2574 74 5169 25 74 34 50 19 2548 0 2573 98 101 25 25 2600 76 2548 0 1 2623 100 75 75 50 202 49 50 100 0 75 75 
92 25 25 10 50 2572 74 5165 25 74 36 50 22 2546 0 2571 96 101 25 25 2600 76 2546 0 1 2621 100 75 75 50 201 50 48 100 0 75 75 
93 25 25 10 50 2572 74 5165 25 74 36 50 22 2546 0 2571 96 101 25 25 2600 76 2546 0 1 2621 100 75 75 50 201 50 48 100 0 75 75 
94 25 25 10 50 2572 74 5165 25 74 36 50 22 2546 0 2571 96 101 25 25 2600 76 2546 0 1 2621 100 75 75 50 201 50 48 100 0 75 75 
95 25 25 10 50 2572 74 5165 25 74 36 50 22 2546 0 2571 96 101 25 25 2600 76 2546 0 1 2621 100 75 75 50 201 50 48 100 0 75 75 
96 25 25 10 50 2572 74 5165 25 74 36 50 22 2546 0 2571 96 101 25 25 2600 76 2546 0 1 2621 100 75 75 50 201 50 48 100 0 75 75 
97 25 25 10 50 2572 74 5165 25 74 36 50 22 2546 0 2571 96 101 25 25 2600 76 2546 0 1 2621 100 75 75 50 201 50 48 100 0 75 75 
98 25 25 10 50 2572 74 5165 25 74 36 50 22 2546 0 2571 96 101 25 25 2600 76 2546 0 1 2621 100 75 75 50 201 50 48 100 0 75 75 
99 25 25 10 50 2572 74 5165 25 74 36 50 22 2546 0 2571 96 101 25 25 2600 76 2546 0 1 2621 100 75 75 50 201 50 48 100 0 75 75 
100 25 25 10 50 2572 74 5165 25 74 36 50 22 2546 0 2571 96 101 25 25 2600 76 2546 0 1 2621 100 75 75 50 201 50 48 100 0 75 75 
