# Number of times each instruction is exectued in deme 0
# Tue Aug 21 13:48:44 2007
#  1: update
#  2: Inst 0
#  3: Inst 1
#  4: Inst 2
#  5: Inst 3
#  6: Inst 4
#  7: Inst 5
#  8: Inst 6
#  9: Inst 7
# 10: Inst 8
# 11: Inst 9
# 12: Inst 10
# 13: Inst 11
# 14: Inst 12
# 15: Inst 13
# 16: Inst 14
# 17: Inst 15
# 18: Inst 16
# 19: Inst 17
# 20: Inst 18
# 21: Inst 19
# 22: Inst 20
# 23: Inst 21
# 24: Inst 22
# 25: Inst 23
# 26: Inst 24
# 27: Inst 25
# 28: Inst 26
# 29: Inst 27
# 30: Inst 28
# 31: Inst 29
# 32: Inst 30
# 33: Inst 31
# 34: Inst 32

0 0 0 0 0 0 0 0 0 0 0 0 0 0 0 0 0 0 0 0 0 0 0 0 0 0 0 0 0 0 0 0 0 0 
10 0 0 0 0 0 0 0 0 0 0 0 0 0 0 0 8 56 4 4 168 8 168 0 0 168 0 0 0 0 0 0 0 0 
20 0 0 2 0 0 0 0 0 0 0 0 0 0 0 0 28 194 14 14 588 28 588 0 0 588 0 2 0 0 0 0 0 0 
30 0 0 5 0 0 0 0 0 0 0 0 0 0 0 0 80 551 40 40 1676 80 1676 0 0 1676 0 5 0 0 0 0 2 0 
40 42 0 14 0 0 0 0 0 0 0 2 1 0 0 0 152 1057 77 77 3187 156 3187 0 0 3187 0 12 0 0 2 0 7 0 
50 62 1 31 0 0 40 0 0 11 0 3 2 0 0 4 190 1368 100 100 4134 204 4134 0 0 4095 0 18 2 0 4 0 2 0 
60 23 1 21 0 0 20 4 0 0 2 8 2 0 0 2 195 1365 100 100 4180 201 4178 0 1 4159 0 17 1 1 3 4 3 0 
70 0 0 0 0 0 0 0 0 0 0 0 0 0 0 0 8 56 4 4 168 8 168 0 0 168 0 0 0 0 0 0 0 0 
80 0 0 0 2 0 0 0 0 0 0 0 0 0 0 0 22 152 11 11 462 22 462 0 0 462 0 0 0 0 0 0 0 0 
90 0 0 2 4 0 3 0 0 0 0 0 0 0 0 0 62 428 31 31 1307 62 1307 0 0 1307 0 0 0 0 0 0 0 0 
100 0 0 2 12 0 8 0 0 3 0 0 0 0 0 2 148 1017 74 74 3120 148 3120 0 0 3120 0 0 0 0 0 0 0 0 
