# Number of times each instruction is exectued in deme 0
# Wed Apr 18 15:08:04 2012
#  1: update
#  2: Inst 0
#  3: Inst 1
#  4: Inst 2
#  5: Inst 3
#  6: Inst 4
#  7: Inst 5
#  8: Inst 6
#  9: Inst 7
# 10: Inst 8
# 11: Inst 9
# 12: Inst 10
# 13: Inst 11
# 14: Inst 12
# 15: Inst 13
# 16: Inst 14
# 17: Inst 15
# 18: Inst 16
# 19: Inst 17
# 20: Inst 18
# 21: Inst 19
# 22: Inst 20
# 23: Inst 21
# 24: Inst 22
# 25: Inst 23
# 26: Inst 24
# 27: Inst 25
# 28: Inst 26
# 29: Inst 27
# 30: Inst 28
# 31: Inst 29
# 32: Inst 30
# 33: Inst 31
# 34: Inst 32

0 0 0 0 0 0 0 0 0 0 0 0 0 0 0 0 0 0 0 0 0 0 0 0 0 0 0 0 0 0 0 0 0 0 
10 0 0 0 0 0 0 0 0 0 0 0 0 0 0 0 8 56 4 4 168 8 168 0 0 168 0 0 0 0 0 0 0 0 
20 42 0 0 0 0 0 0 0 0 0 0 0 0 0 0 30 210 15 15 588 30 588 0 0 588 0 0 0 0 0 0 0 0 
30 42 0 2 0 0 0 0 0 0 0 0 0 0 0 0 62 432 31 31 1258 62 1258 0 0 1258 0 0 0 0 0 0 0 0 
40 42 0 3 0 0 0 0 0 43 0 0 0 0 0 0 115 795 57 57 2353 114 2353 0 0 2356 0 0 0 0 0 0 0 0 
50 52 0 9 2 0 0 2 0 0 3 0 0 0 0 0 194 1332 96 96 3951 192 3951 0 0 3956 0 2 2 13 0 0 0 0 
60 66 0 32 3 0 0 1 0 0 3 2 2 0 0 0 201 1379 100 100 4120 200 4120 0 11 4106 1 1 3 13 0 0 1 0 
70 0 0 0 0 0 0 0 0 0 4 0 0 0 0 0 8 56 4 4 168 8 168 0 0 168 0 0 0 0 0 0 0 0 
80 0 0 0 0 0 0 0 0 0 14 0 0 0 0 0 28 196 14 14 588 28 588 0 0 588 0 0 0 0 0 0 0 0 
90 0 0 2 0 0 0 0 0 0 29 0 3 0 0 0 58 406 29 29 1216 58 1216 0 0 1216 0 0 0 2 0 0 0 0 
100 84 0 51 0 2 0 0 42 0 61 0 10 0 2 0 122 851 61 61 2472 122 2472 0 0 2430 4 0 0 0 0 0 0 3 
