# Number of times each instruction is exectued in deme 1
# Tue Feb 19 09:51:21 2008
#  1: update
#  2: Inst 0
#  3: Inst 1
#  4: Inst 2
#  5: Inst 3
#  6: Inst 4
#  7: Inst 5
#  8: Inst 6
#  9: Inst 7
# 10: Inst 8
# 11: Inst 9
# 12: Inst 10
# 13: Inst 11
# 14: Inst 12
# 15: Inst 13
# 16: Inst 14
# 17: Inst 15
# 18: Inst 16
# 19: Inst 17
# 20: Inst 18
# 21: Inst 19
# 22: Inst 20
# 23: Inst 21
# 24: Inst 22
# 25: Inst 23
# 26: Inst 24
# 27: Inst 25
# 28: Inst 26
# 29: Inst 27
# 30: Inst 28
# 31: Inst 29
# 32: Inst 30
# 33: Inst 31
# 34: Inst 32

0 0 0 0 0 0 0 0 0 0 0 0 0 0 0 0 0 0 0 0 0 0 0 0 0 0 0 0 0 0 0 0 0 0 
10 0 0 0 0 0 0 0 0 0 0 0 0 0 0 0 0 0 0 0 0 0 0 0 0 0 0 0 0 0 0 0 0 0 
20 0 0 0 0 0 0 0 0 0 0 0 0 0 0 0 0 0 0 0 0 0 0 0 0 0 0 0 0 0 0 0 0 0 
30 0 0 0 0 0 0 0 0 0 0 0 0 0 0 0 0 0 0 0 0 0 0 0 0 0 0 0 0 0 0 0 0 0 
40 0 0 0 0 0 0 0 0 0 0 0 0 0 0 0 0 0 0 0 0 0 0 0 0 0 0 0 0 0 0 0 0 0 
50 0 0 0 0 0 0 0 0 0 0 0 0 0 0 0 0 0 0 0 0 0 0 0 0 0 0 0 0 0 0 0 0 0 
60 0 0 0 0 0 0 0 0 0 0 0 0 0 0 0 0 0 0 0 0 0 0 0 0 0 0 0 0 0 0 0 0 0 
70 0 0 0 0 0 0 0 0 0 0 0 0 0 0 0 4 28 2 2 42 4 42 0 0 44 0 0 0 0 0 0 0 0 
80 0 0 0 0 0 0 0 0 0 0 0 0 0 0 0 4 28 2 2 42 4 42 0 0 44 0 0 0 0 0 0 0 0 
90 0 0 0 0 0 0 0 0 0 0 0 0 0 0 0 4 28 2 2 42 4 42 0 0 44 0 0 0 0 0 0 0 0 
100 0 0 0 0 0 0 0 0 0 0 0 0 0 0 0 4 28 2 2 42 4 42 0 0 44 0 0 0 0 0 0 0 0 
