# Avida instruction execution data
# Thu Feb 26 17:54:02 2009
#  1: Update
#  2: nop-A
#  3: nop-B
#  4: nop-C
#  5: if-n-equ
#  6: if-less
#  7: pop
#  8: push
#  9: swap-stk
# 10: swap
# 11: shift-r
# 12: shift-l
# 13: inc
# 14: dec
# 15: add
# 16: sub
# 17: nand
# 18: IO
# 19: h-alloc
# 20: h-divide
# 21: h-copy
# 22: h-search
# 23: mov-head
# 24: jmp-head
# 25: get-head
# 26: if-label
# 27: set-flow
# 28: sense-m100
# 29: if-equ-0
# 30: time
# 31: sleep1
# 32: sleep2
# 33: sleep3
# 34: sleep4

0 0 0 0 0 0 0 0 0 0 0 0 0 0 0 0 0 0 0 0 0 0 0 0 0 0 0 0 0 0 0 0 0 0 
10 0 0 0 0 0 0 0 0 0 0 0 0 0 0 0 8 56 4 4 168 8 168 0 0 168 0 0 0 0 0 0 0 0 
20 42 0 0 0 0 0 0 0 0 0 0 0 0 0 0 30 210 15 15 588 30 588 0 0 588 0 0 0 0 0 0 0 0 
30 42 0 2 0 0 0 0 0 0 0 0 0 0 0 0 62 432 31 31 1258 62 1258 0 0 1258 0 0 0 0 0 0 0 0 
40 42 0 5 0 0 0 0 0 43 0 0 0 0 0 0 120 819 59 59 2433 118 2433 0 0 2436 0 0 0 0 0 0 0 0 
50 0 0 14 2 6 0 0 0 0 2 2 0 0 0 0 197 1319 96 96 4007 192 4009 0 0 4013 0 1 0 0 0 0 0 2 
60 0 0 20 3 2 2 0 0 2 6 1 0 0 2 0 203 1365 100 100 4173 200 4172 0 0 4174 0 2 0 4 1 4 1 0 
70 0 0 0 0 0 0 0 0 0 0 0 0 0 0 0 8 56 4 4 84 8 84 0 0 88 0 0 0 0 0 0 0 0 
80 0 0 0 0 0 0 0 0 0 0 0 0 0 0 0 8 56 4 4 84 8 84 0 0 88 0 0 0 0 0 0 0 0 
90 0 0 0 0 0 0 0 0 0 0 0 0 0 0 0 8 56 4 4 84 8 84 0 0 88 0 0 0 0 0 0 0 0 
100 0 0 0 0 0 0 0 0 0 0 0 0 0 0 0 8 56 4 4 84 8 84 0 0 88 0 0 0 0 0 0 0 0 
